{
  "name": "Level 5 – Saltas ou Ficas?",
  "tileSize": 6,
  "wallHeight": 6,
  "borderThickness": 1,

  "colors": {
    "floor": "#D3CA79",
    "wall": "#0F223D"
  },

  "fog": { "color": "#000000", "near": 30, "far": 90 },

  "start": { "x": 1, "z": 1 },
  "end": { "x": 11, "z": 11 },

  "portalStart": {
    "ringColor": "#E83F25",
    "baseColor": "#3F1F1F",
    "lightColor": "#E83F25",
    "height": 1.7
  },
  "portalEnd": {
    "ringColor": "#FFD700",
    "baseColor": "#554422",
    "lightColor": "#FFD700",
    "height": 1.5
  },

  "map": [
    [1, 1, 1, 1, 1, 1, 1, 1, 1, 1, 1, 1, 1, 1, 1, 1, 1, 1, 1, 1, 1, 1, 1],
    [1, 0, 2, 0, 1, 1, 0, 1, 1, 0, 1, 0, 1, 1, 0, 1, 1, 1, 0, 2, 0, 0, 1],
    [1, 2, 1, 0, 2, 0, 0, 0, 2, 0, 1, 0, 2, 0, 0, 1, 1, 1, 2, 1, 1, 1, 1],
    [1, 0, 1, 0, 1, 0, 1, 0, 1, 1, 1, 0, 1, 1, 1, 1, 1, 0, 0, 1, 0, 0, 1],
    [1, 2, 1, 1, 1, 0, 1, 0, 1, 0, 2, 0, 0, 1, 1, 1, 1, 1, 0, 1, 2, 1, 1],
    [1, 0, 0, 1, 1, 2, 1, 0, 1, 0, 1, 1, 1, 1, 0, 0, 2, 0, 0, 0, 0, 1, 1],
    [1, 1, 0, 0, 1, 0, 1, 1, 1, 0, 0, 0, 0, 1, 2, 1, 1, 1, 0, 1, 1, 1, 1],
    [1, 0, 1, 0, 1, 0, 0, 1, 1, 2, 1, 1, 1, 1, 0, 1, 1, 1, 2, 1, 1, 1, 1],
    [1, 2, 1, 0, 1, 1, 0, 0, 1, 0, 0, 0, 2, 0, 0, 0, 0, 1, 0, 0, 0, 1, 1],
    [1, 0, 0, 0, 1, 0, 0, 1, 1, 1, 1, 2, 1, 1, 1, 1, 0, 0, 0, 1, 0, 0, 1],
    [1, 2, 1, 0, 0, 0, 1, 1, 1, 1, 1, 0, 1, 1, 1, 1, 0, 1, 0, 1, 1, 1, 1],
    [1, 0, 0, 0, 1, 1, 1, 0, 0, 2, 0, 0, 0, 2, 0, 0, 0, 1, 2, 1, 0, 0, 1],
    [1, 0, 1, 0, 2, 0, 1, 1, 1, 1, 1, 0, 1, 1, 1, 1, 0, 0, 0, 1, 0, 1, 1],
    [1, 1, 0, 0, 1, 0, 1, 1, 1, 1, 1, 2, 1, 1, 1, 1, 1, 0, 1, 1, 0, 1, 1],
    [1, 0, 0, 1, 1, 0, 0, 1, 0, 0, 2, 0, 0, 0, 1, 1, 1, 0, 0, 2, 0, 1, 1],
    [1, 1, 0, 1, 1, 0, 1, 1, 2, 1, 1, 1, 1, 0, 0, 0, 0, 0, 1, 1, 1, 1, 1],
    [1, 1, 0, 0, 1, 0, 1, 1, 0, 0, 0, 0, 1, 2, 1, 0, 1, 1, 1, 0, 0, 0, 1],
    [1, 1, 1, 2, 1, 0, 0, 1, 1, 1, 1, 0, 0, 0, 1, 0, 0, 0, 0, 0, 1, 0, 1],
    [1, 0, 0, 0, 1, 1, 0, 2, 0, 0, 1, 0, 1, 1, 1, 0, 1, 1, 1, 2, 1, 2, 1],
    [1, 1, 2, 1, 1, 1, 0, 1, 1, 0, 0, 0, 1, 0, 0, 0, 2, 0, 0, 0, 0, 0, 1],
    [1, 0, 0, 1, 0, 0, 0, 2, 0, 0, 1, 1, 1, 2, 1, 0, 1, 0, 1, 0, 1, 1, 1],
    [1, 1, 0, 2, 0, 1, 0, 1, 0, 1, 1, 0, 0, 0, 1, 0, 1, 0, 1, 0, 0, 0, 1],
    [1, 1, 1, 1, 1, 1, 1, 1, 1, 1, 1, 1, 1, 1, 1, 1, 1, 1, 1, 1, 1, 1, 1]
  ]

}
